┍━━━━━━━━━━━━━━━━━━━━━━━━━━━━━━━━━━━━━━━━━━━━━━━━━━━━━━━━━━━━━━━━━━━┑
│ %LINE0                                                          % │
│ %LINE1                                                          % │
│ %LINE2                                                          % │
│ %LINE3                                                          % │
│ %LINE4                                                          % │
│ %LINE5                                                          % │
│ %LINE6                                                          % │
┕━━━━━━━━━━━━━━━━━━━━━━━━━━━━━━━━━━━━━━━━━━━━━━━━━━━━━━━━━━━━━━━━━━━┙
┍━━━━━━━━━━━━━━━━━━━━━━━━━━━━━━━━━━━━━━━━━━━━━━━━━━━━━━━━━━━━━━━━━━━┑
│                                                                   │
│   Commands :                                                      │
│                                                                   │
│   north                                                           │
│   east                                                            │
│   south                                                           │
│   west                                                            │
│                                                                   │
┕━━━━━━━━━━━━━━━━━━━━━━━━━━━━━━━━━━━━━━━━━━━━━━━━━━━━━━━━━━━━━━━━━━━┙

> 